BBBBBBBBBBBBBBBBBBBBBBBBBBBBBBBBBBBBBBBBBBBBBBBBBB
BSSSSSSSSSSSSSSSSSSSSSSSSSSSSSSSSSSSSSSSSSSSSSSSSSBB
BSRRRRRRRRRRRSRRRRRRRRRRRSRRRRRRRRRRRSRRRRRRRRRRRRSB
BSRRRRRRRRRRRSRRRRRRRRRRRSRRRRRRRRRRRSRRRRRRRRRRRRSB
BSRRRRRRRRRRRSRRRRRRRRRRRSRRRRRRRRRRRSRRRRRRRRRRRRSB
BSRRRRRRRRRRRSRRRRRRRRRRRSRRRRRRRRRRRSRRRRRRRRRRRRSB
BSSSSSTSSSSSSSTSSSSSSSTSSSSSSSTSSSSSSSTSSSSSSSSSSBB
BBBBBBBSBBBBBBBSBBBBBBBSBBBBBBBSBBBBBBBSBBBBBBBSBBBB
BSSSSSSSSSSSSSSSSSSSSSSSSSSSSSSSSSSSSSSSSSSSSSSSSSBB
BSRRRRRRRRRRRSRRRRRRRRRRRSRRRRRRRRRRRSRRRRRRRRRRRRSB
BSRRRRRRRRRRRSRRRRRRRRRRRSRRRRRRRRRRRSRRRRRRRRRRRRSB
BSRRRRRRRRRRRSRRRRRRRRRRRSRRRRRRRRRRRSRRRRRRRRRRRRSB
BSRRRRRRRRRRRSRRRRRRRRRRRSRRRRRRRRRRRSRRRRRRRRRRRRSB
BSSSSSTSSSSSSSTSSSSSSSTSSSSSSSTSSSSSSSTSSSSSSSSSSBB
BBBBBBBSBBBBBBBSBBBBBBBSBBBBBBBSBBBBBBBSBBBBBBBSBBBB
BSSSSSSSSSSSSSSSSSSSSSSSSSSSSSSSSSSSSSSSSSSSSSSSSSBB
BSRRRRRRRRRRRSRRRRRRRRRRRSRRRRRRRRRRRSRRRRRRRRRRRRSB
BSRRRRRRRRRRRSRRRRRRRRRRRSRRRRRRRRRRRSRRRRRRRRRRRRSB
BSRRRRRRRRRRRSRRRRRRRRRRRSRRRRRRRRRRRSRRRRRRRRRRRRSB
BSRRRRRRRRRRRSRRRRRRRRRRRSRRRRRRRRRRRSRRRRRRRRRRRRSB
BSSSSSTSSSSSSSTSSSSSSSTSSSSSSSTSSSSSSSTSSSSSSSSSSBB
BBBBBBBBBBBBBBBBBBBBBBBBBBBBBBBBBBBBBBBBBBBBBBBBBB
